2 28 28
10 13 13 10 10 10 10 10 13 13 10 10 10 10 10 10 10 10 10 10 10 10 10 10 10 10 10 10 
10 13 13 10 10 10 10 10 13 13 10 10 10 10 10 10 10 10 10 10 10 10 10 10 10 10 10 10 
10 10 10 10 10 10 10 10 10 10 10 10 10 10 10 10 10 10 10 10 10 10 10 10 10 10 10 10 
10 10 10 10 10 10 10 10 10 10 10 10 10 10 10 10 10 10 10 10 10 10 10 10 10 10 10 10 
10 10 10 10 10 10 10 10 10 10 10 10 10 10 10 10 10 10 10 10 10 10 10 10 10 10 10 10 
10 10 10 10 10 10 10 10 10 10 10 10 10 10 10 10 10 10 10 10 10 10 10 10 10 10 10 10 
10 10 10 10 10 10 10 10 13 13 10 10 10 10 10 10 10 10 10 10 10 10 10 10 10 10 10 10 
10 10 10 10 10 10 10 13 13 13 10 10 10 10 10 10 10 10 10 10 10 10 10 10 10 10 10 10 
10 10 10 10 10 10 10 10 10 10 10 10 10 10 10 10 10 10 10 10 10 10 10 10 10 10 10 10 
10 10 10 10 10 10 10 10 10 10 10 10 10 10 10 10 10 10 10 10 10 10 10 10 10 10 10 10 
10 10 10 10 10 10 10 10 10 10 10 10 10 10 10 10 10 10 10 10 10 10 10 10 10 10 10 10 
10 10 10 10 10 10 10 10 10 10 10 10 10 10 10 10 10 10 10 10 10 10 10 10 10 10 10 10 
10 10 10 10 10 10 10 10 10 10 10 10 10 10 10 10 10 10 10 10 10 10 10 10 10 10 10 10 
10 10 10 10 10 10 10 10 10 10 10 10 10 10 10 10 10 10 10 10 10 10 10 10 10 10 10 10 
10 10 10 10 10 10 10 10 10 10 10 10 10 10 10 10 10 10 10 10 10 10 10 10 10 10 10 10 
10 10 10 10 10 10 10 10 10 10 10 10 13 13 13 13 13 13 13 13 10 10 10 10 10 10 10 10 
10 10 10 10 10 10 10 10 10 10 10 10 13 13 13 13 13 13 13 13 13 13 10 10 10 10 10 10 
10 10 10 10 10 10 10 10 10 10 13 13 13 13 13 13 13 13 13 13 13 13 10 10 10 10 10 10 
10 10 10 10 10 10 10 10 10 10 13 13 13 13 13 13 13 13 13 13 13 13 10 10 10 10 10 10 
10 10 10 10 10 10 10 10 10 10 13 13 13 13 13 13 13 13 13 13 13 13 10 10 10 10 10 10 
10 10 10 10 10 10 10 10 10 10 13 13 13 13 13 13 13 13 13 13 13 10 10 10 10 10 10 10 
10 10 10 10 10 10 10 10 10 10 13 13 13 13 13 13 13 13 13 13 13 10 10 10 10 10 10 10 
10 10 10 10 10 10 10 10 10 10 10 10 13 13 13 13 13 13 10 10 10 10 10 10 10 10 10 10 
10 10 10 10 10 10 10 10 10 10 10 10 10 10 10 10 10 10 10 10 10 10 10 10 10 10 10 10 
10 10 10 10 10 10 10 10 10 10 10 10 10 10 10 10 10 10 10 10 10 10 10 10 10 10 10 10 
10 10 10 10 10 10 10 10 10 10 10 10 10 10 10 10 10 10 10 10 10 10 10 10 10 10 10 10 
10 10 10 10 10 10 10 10 10 10 10 10 10 10 10 10 10 10 10 10 10 10 10 10 10 10 10 10 
10 10 10 10 10 10 10 10 10 10 10 10 10 10 10 10 10 10 10 10 10 10 10 10 10 10 10 10 

0 0 0 0 0 0 0 0 0 0 0 0 0 4 0 0 0 0 0 0 0 0 0 0 0 0 0 0 
5 0 0 0 0 0 4 0 0 0 400 400 400 4 0 0 0 0 0 0 0 0 0 0 0 0 0 0 
5 0 0 5 0 0 0 0 0 400 0 0 0 400 0 0 0 0 0 0 0 0 0 0 0 0 0 0 
0 0 0 0 0 4 5 0 400 0 0 0 0 0 400 0 0 0 0 0 0 0 0 0 0 0 0 0 
0 0 0 0 0 4 0 0 400 0 0 1 0 0 400 0 4 0 0 0 0 0 0 0 0 0 0 0 
0 0 0 0 0 0 0 0 400 0 0 0 0 0 400 0 0 5 0 0 0 0 0 0 0 0 0 0 
0 0 0 0 0 0 5 0 0 400 0 0 0 400 0 3 0 5 0 0 0 0 0 0 0 0 0 0 
0 0 0 0 0 0 0 0 0 0 400 400 400 0 0 0 0 0 0 0 0 0 0 0 0 0 0 0 
0 0 0 0 0 4 0 0 0 5 0 5 0 0 0 0 0 0 0 0 0 0 0 0 0 0 0 0 
0 5 0 0 0 0 0 0 0 0 0 0 0 0 0 0 4 0 0 0 0 0 0 0 0 0 0 0 
0 0 0 0 0 0 0 0 0 0 0 0 0 0 0 0 0 0 0 0 0 0 0 0 0 0 0 0 
0 0 0 0 0 0 0 0 0 0 0 0 0 0 0 0 0 0 0 0 0 0 0 0 0 0 0 0 
0 0 0 0 0 0 0 0 0 0 0 0 0 5 0 0 0 0 0 0 0 0 0 0 0 0 0 0 
0 0 0 0 0 0 0 0 0 0 5 4 0 5 0 0 0 4 0 0 0 0 0 0 0 0 0 0 
0 0 0 0 0 0 0 5 5 4 0 0 0 5 0 0 5 5 0 5 0 5 5 0 0 0 0 0 
0 0 0 400 0 0 0 5 0 0 0 0 0 0 0 0 0 0 0 0 0 0 0 0 0 0 0 0 
0 0 0 0 0 0 0 0 5 0 0 0 0 0 0 0 0 0 0 0 0 0 4 0 0 0 0 0 
0 0 0 0 0 0 0 0 0 0 0 0 0 0 0 0 0 0 0 0 0 0 0 0 0 0 0 0 
0 0 400 0 0 400 0 0 0 0 0 0 0 0 0 0 0 0 0 0 0 0 0 4 0 0 0 0 
0 0 0 0 400 0 0 0 0 0 0 0 0 400 0 0 0 0 0 0 0 0 0 4 0 0 0 0 
0 0 400 0 0 0 0 0 0 0 0 0 0 0 0 0 0 0 0 0 0 0 0 0 0 4 0 0 
0 0 0 400 0 0 0 5 4 0 0 0 0 0 0 0 0 0 0 0 0 4 0 0 0 5 0 0 
0 0 0 0 0 0 0 0 4 0 0 0 0 0 0 0 0 0 0 0 0 4 4 0 0 5 0 0 
0 400 0 0 0 0 0 0 0 0 0 0 0 0 0 0 4 0 0 0 0 0 0 0 0 5 0 0 
0 0 0 0 400 0 0 0 0 0 0 4 0 0 4 0 0 0 0 0 0 0 0 0 0 5 0 0 
0 0 0 0 0 0 0 0 0 0 0 0 0 0 0 0 0 4 5 0 0 0 5 5 5 5 0 0 
0 0 0 0 0 0 0 0 0 0 0 0 0 0 0 0 0 4 0 0 0 0 0 0 0 0 0 0 
0 0 0 0 0 0 0 0 0 0 0 0 0 0 0 0 0 0 0 0 0 0 0 0 0 0 0 0 

