2 19 10
7 7 7 7 7 7 7 7 7 7 7 7 7 6 6 6 6 6 6 
7 7 7 7 7 7 7 7 7 7 7 6 6 6 6 6 6 7 7 
7 7 7 7 7 7 7 7 7 7 6 6 6 6 6 6 7 7 7 
7 7 7 7 7 7 7 7 7 6 6 6 6 6 7 7 7 7 7 
7 7 7 7 7 7 7 6 6 6 6 6 6 7 7 7 7 7 7 
7 7 7 7 7 7 6 6 6 6 6 6 7 7 7 7 7 7 7 
7 7 7 7 7 6 6 6 6 6 6 4 7 7 7 7 7 7 7 
7 7 7 6 6 6 6 6 6 6 7 7 7 7 7 7 7 7 7 
7 7 6 6 6 6 6 6 7 7 7 7 7 7 7 7 7 7 7 
6 6 6 6 6 6 6 7 7 7 7 7 7 7 7 7 7 7 7 

0 0 0 0 0 0 0 2 0 0 0 0 0 0 0 0 0 0 0 
4 4 2 2 2 0 4 2 0 0 2 0 0 0 0 0 0 0 0 
0 2 4 0 0 2 0 2 4 0 0 0 0 0 0 0 0 0 0 
0 2 0 4 4 0 0 2 0 0 0 0 0 0 0 0 0 0 0 
2 2 0 4 4 4 2 0 0 0 0 0 0 0 0 0 0 0 3 
0 4 0 4 4 0 0 1 0 0 0 0 0 0 0 3 3 0 3 
0 4 2 4 2 0 0 0 0 0 0 0 0 3 3 3 3 3 3 
4 0 0 0 0 0 0 0 0 0 0 3 3 0 3 3 0 3 3 
0 4 149 149 149 0 0 0 0 0 3 3 0 0 3 3 3 3 0 
0 0 0 0 149 149 0 0 0 0 3 0 3 3 3 3 3 0 3 

